assignBukNumberTypeAliasGenericInterbanking	InterBanking	asignar
assignBukNumberTypeAliasInterbanking	InterBanking	asginarAlias
calculateCreditCardChangeCategory	Nsbt	CalculaTipoNovedadTC
calculateCreditCardLimit	NSBT-FU	calcularLimiteTarjetaCredito
calculateCreditLimitPercentage	NSBT-FU	CalculaPorcentajeEntreDosValores
calculateCustomerCreditLimit	SPSS	Politica5
calculateExportLicenseEticket	NSBT-COMEX	CalculaTotalesDespachos
calculateFundRescue	Nsbt	CalculaImporteFCI
calculateQuotedAmount	Nsbt	ConsultaCotizacionesMonedas
deleteAccountBook	Nsbt	ABMAgendaDeCBU
deleteAccountBookBeneficiary	NSBT-COMEX	AgendaDeTransferenciasComex
deleteAccountBukNumberAlias	Banelco	bajaAlias
deleteAccountDebinOrigin	InterBanking	eliminarCuentaVendedor
deleteAccountDebinTarget	InterBanking	eliminarCuentaVendedor
deleteAvailableTransactionProcedure	Profiling	removeActionBPM
deleteBatchFileCash	Nsbt	EliminarArchivoCash
deleteBatchFileCashReception	NSBT-CASH	EliminaArchivoRecepcion
deleteCardProspectAdditionalByProcedure	Teradata	DELETE_UT_ACCEPTED_ADDITIONAL_CARD
deleteChannel	Profiling	deleteChannel
deleteContactPhone	Profiling	deleteCellPhone
deleteCreditRatingPersistence	Teradata	DELETE_UT_RATING
deleteCustomerOperationByProcedure	Teradata	DELETE_UT_EXISTING_PRODUCT_MANAGEMENT
deleteEftAccession	NSBT-PERSONAS	BajaAdhesionDebito
deleteEmployer	NSBT-PS	AltaLoteParaBaja
deleteEmployerPaymentBook	NSBT-PS	EliminarListaPagoHabitual
deleteEticketRequest	NSBT-COMEX	transferenciasAlExterior
deleteInsurancePersistence	Teradata	DELETE_UT_INSURANCE_INTEGRATION
deleteOfferAcceptedByProduct	Teradata	DELETE_UT_PROSPECT_ACCEPTED_PRODUCT
deleteOfferComponentAccepted	Teradata	DELETE_UT_PROSPECT_ACCEPTED_OPTIONAL
deleteProcedureTaskProcedure	Profiling	removeProcessBPM
deleteProcedureTypeProcedure	Profiling	removeProcessBPM
deleteProfileGroupProcedure	Profiling	removeProfileBT
deleteProfileProcedure	Profiling	removeRoleBPM
deleteProspectInstitution	Profiling	deletePreadhesion
deleteRelationTypeAliasAndBukNumberInterbanking	InterBanking	eliminarRelacionAliasCBU
deleteRoleType	Profiling	deleteRoleType
deleteSignatureSchema	Profiling	deleteSignatureSchema
deleteSystemUserInstitution	Profiling	wsSystemUserInstitutionDeleteSystemUserInstitution
deleteToken	Nsbt	ValidacionToken
deleteTransactionSetBasic	Profiling	doDeleteTransaccionMonetaria
insertAccountBook	Nsbt	ABMAgendaDeCBU
insertAccountBookBeneficiary	NSBT-COMEX	AgendaDeTransferenciasComex
insertAccountBukNumberAlias	Banelco	altaAlias
insertAccountDebinOrigin	InterBanking	adherirVendedor
insertAccountDebinRequest	Profiling	insertAccountDebinRequest
insertAccountDebinTarget	InterBanking	adherirComprador
insertAuthenticationToUser	Profiling	doOlvidoCredencial
insertAvailableTransactionProcedure	Profiling	insertAccionBPM
insertCardProspectAdditionalAccepted	Teradata	INSERT_UT_ACCEPTED_ADDITIONAL_CARD
insertChannel	Profiling	insertChannel
insertContactPhone	Profiling	insertCellPhone
insertCreditCardDeliveryDate	Teradata	AltaRepacto
insertCreditCardPhysicalByCampaign	Teradata	AltaTarjetaFisicaPorCampania
insertCreditRatingApproved	Nsbt	ImpactaCaliEnBanTotal
insertCreditRatingProspect	Teradata	INSERT_UT_RATING
insertCustomerAdditionalDataFromProspect	Teradata	INSERT_UT_CUSTOMER_ADDITIONAL_DATA
insertCustomerBantotal	NSBT-FU	AltaClienteBantotal
insertCustomerData	Teradata	InsertaDatosCliente
insertCustomerFromProspect	Teradata	INSERT_UT_CUSTOMER_GROUP
insertCustomerMember	Teradata	INSERT_UT_CUSTOMER_GROUP_INTEGRATION
insertCustomerMigration	Profiling	doMigrarCliente
insertCustomerOperation	Profiling	insertCustomerOperarion
insertCustomerOperation	Profiling	insertCustomerOperarion
insertCustomerOperationForProcedure	Teradata	INSERT_UT_EXISTING_PRODUCT_MANAGEMENT
insertCustomerPartner	NSBT-FU	ModificaDatosDelConyuge
insertCustomerPersonAdditionalDataFromProspect	Teradata	INSERT_PROSPECT_ADDITIONAL_DATA
insertCustomerPersonBantotal	NSBT-FU	AltaPersonaBantotal
insertCustomerPersonProspectBasic	Teradata	INSERT_UT_PROSPECT_TARGET
insertDependency	NSBT-PS	AltaDependencia
insertEftAccessionForCustomer	NSBT-PERSONAS	AltaAdhesionDebito
insertEmployer	NSBT-PS	AltaEmpleadoPlantilla
insertEmployerPaymentBook	NSBT-PS	AltaListaPagoHabitual
insertInstitution	Profiling	WSInstitutionAdhesionInsertInstitution
insertInstitution	Profiling	WSInstitutionAdhesionInsertInstitution
insertInstitution	Profiling	WSInstitutionAdhesionInsertInstitution
insertInstitution	Profiling	WSInstitutionAdhesionInsertInstitution
insertInsurancePersistence	Teradata	INSERT_UT_INSURANCE_INTEGRATION
insertNonmonetaryTransaction	Profiling	insertSignatureSchema
insertOfferAccepted	Teradata	INSERT_UT_PROSPECT_ACCEPTED_PRODUCT
insertOfferComponentAccepted	Teradata	INSERT_UT_PROSPECT_ACCEPTED_OPTIONAL
insertProcedureDraftPersistence	Teradata	INSERT_UT_PRE_BPM
insertProcedureLogByProcedure	Teradata	INSERT_UT_BPM_TRACKING
insertProcedurePackagePersistence	Teradata	INSERT_UT_BPM
insertProcedureTaskProcedure	Profiling	insertActivityBPM
insertProcedureTypeProcedure	Profiling	insertProcedureTypeProcedure
insertProfile	Profiling	wsProfileInsertProfile
insertProfileGroupProcedure	Profiling	insertProfileBT
insertProfileProcedure	Profiling	insertRoleBPM
insertProspectAdministratorPassword	Profiling	WSPreadhesionClientesAltaClave
insertProspectInstitution	Profiling	insertPreadhesion
insertProspectML	Teradata	InsertaCalificacion
insertRoleType	Profiling	insertRoleType
insertSecurityItem	Profiling	wsSecurityItemInsertSecurityItem
insertSecurityItem	Profiling	wsSecurityItemInsertSecurityItem
insertSignatureSchema	Profiling	insertSignatureSchema_esquema
insertSystemUserBank	Profiling	wsInsertSystemUserBank
insertSystemUserInstitution	Profiling	insertSystemUserInstitution
insertSystemUserMigration	Profiling-Personas	doMigrarCliente
insertTicketSky	Nsbt	InsertarTicketSky
massiveSelectAccountBalance	Nsbt	ConsultaSaldoCuentas
massiveSelectAccountBook	Nsbt	ConsultaAgendaDeCBU
massiveSelectAccountBookBeneficiary	NSBT-COMEX	agendaBeneficiarios
massiveSelectAccountByPackageProduct	NSBT-FU	ConsultaDeProductosPorPaqueteSinTarjetasDelCliente
massiveSelectAccountCash	Nsbt	ConsultaCuentasPagosCashPorAdherente
massiveSelectAccountDebinRequest	Profiling	massiveSelectRequestAccountDebin
massiveSelectAccountDetailByProductId	NSBT-FU	singleSelectAccountDetailByProductId
massiveSelectAccountJudicial	Nsbt	ConsultaDeCuentasJudiciales
massiveSelectAffectationByImportOperation	NSBT-COMEX	consultaDeAfectacionesOperacion
massiveSelectAffectationByImportRegistry	NSBT-COMEX	consultaDeAfectacionesRegistro
massiveSelectAgreementByAccount	Nsbt	ConsultaAcuerdosPorCuenta
massiveSelectAvailableTransactionByMatrix	Profiling	massiveSelectActionMatrix
massiveSelectAvailableTransactionByProcedureTask	Profiling	massiveSelectActionBTBPM
massiveSelectAvailableTransactionProcedureByFilter	Profiling	massiveSelectActionFilter
massiveSelectAvailableTransactionProcedureByProfile	Profiling	massiveSelectAction
massiveSelectBantotalAccountByExampleForAdhesion	Nsbt	ConsultaProductos
massiveSelectBatchFileCashCollectionHist	Profiling	massiveSelectSignatureSchema
massiveSelectBatchFileCashContent	NSBT-CASH	ObtenerContenidoDeArchivo
massiveSelectBatchFileCashPaymentHist	Profiling	wsTransaccionesMonetariasDoConsultaPagosCashPorFiltro
massiveSelectBatchFileCashReception	NSBT-CASH	ConsultaRecepcionArchivos
massiveSelectBatchFileCashReceptionDownload	NSBT-CASH	DescargaArchivoRecepcion
massiveSelectBatchFileCashTypeByAdherent	Nsbt	ConsultaTipoArchivoRecepcion
massiveSelectBatchFileDownloadToken	Nsbt	DescargaArchivos
massiveSelectBatchFileErrorCash	Nsbt	ConsultaDeErroresDeArchivo
massiveSelectBatchFileEventStatus	NSBT-PS	ConsultaDetalleProcesoEnvio
massiveSelectBranch	Nsbt	ConsultaSucursalesActivas
massiveSelectCampaignByPerson	NSBT-FU	ConsultaCampaniasPorPersona
massiveSelectCampaignOfferBySegment	NSBT-FU	ConsultaDeCampanasPorSegmento
massiveSelectCardDbByCustomers	NSBT-FU	ConsultaDeTarjetasDeDebitoMultiplesPorTitulares
massiveSelectCardDbByCustomersBasic	NSBT-FU	ConsultaDeTarjetasDeDebitoMultiplesPorTitulares
massiveSelectCardDbByMembers	NSBT-FU	ConsultaDeTarjetasDeDebitoPorTitulares
massiveSelectCardProspectAdditionalByProcedure	Teradata	SELECT_UT_ACCEPTED_ADDITIONAL_CARD
massiveSelectCardProspectAddtionalByProcedureFilter	Teradata	SELECT_UT_ACCEPTED_ADDITIONAL_CARD
massiveSelectCashAdherentMepEnable	NSBT-CASH	ConsultaDeAdherentesHabilitadosParaMEP
massiveSelectCashAgreementByAdherent	Nsbt	ConsultaConvenioAdherente
massiveSelectChannel	Profiling	massiveSelectChannel
massiveSelectChannelCollection	NSBT-CASH	PosicionIntegralCobros
massiveSelectCheckDetailAccreditValues	Nsbt	ConsultaValoresAcreditar
massiveSelectCheckDetailBounced	Nsbt	ConsultaChequesRechazados
massiveSelectCheckDetailCashRecovery	NSBT-CASH	ConsultaChequesRecupero
massiveSelectCheckDetailCashStatus	Nsbt	ConsultaSituacionCheques
massiveSelectCheckDetailCustody	Nsbt	ConsultaChequesCustodia
massiveSelectCheckDetailDeposited	Nsbt	ConsultaChequesDepositadosCuenta
massiveSelectCheckDetailDepositedValues	Nsbt	ConsultaValoresDepositados
massiveSelectCheckDetailGuarantee	Nsbt	ConsultaChequesGarantia
massiveSelectCheckDetailNegotiated	Nsbt	ConsultaChequesNegociados
massiveSelectCheckDetailReceived	NSBT-CASH	ConsultaChequesRecibidos
massiveSelectCheckDetailRecovered	NSBT-CASH	ListaRecuperoCPD
massiveSelectCheckDetailRecoveredByBatchId	NSBT-CASH	DetalleHistorialRecupero
massiveSelectCollection	NSBT-CASH	ConsultaDetallePosicionIntegralCobros
massiveSelectCreditCardAdditionalByAccount	NSBT-FU	ConsultaDeAdicionalesDeTC
massiveSelectCreditCardCashStatus	Nsbt	ConsultaTarjetas
massiveSelectCreditCardEquivalent	Teradata	SELECT_UT_TC_CAMPAIGN_PRODUCT
massiveSelectCreditLetterByOperation	Nsbt	ConsultaCartasCredito
massiveSelectCreditLetterOvercome	Nsbt	ConsultaCartasCredito_Overcome_Overdue
massiveSelectCreditLetterOverdue	Nsbt	ConsultaCartasCredito_Overcome_Overdue
massiveSelectCreditLetterUpdates	NSBT-COMEX	ConsultaDeModificacionesDeCartaDeCredito
massiveSelectCreditRatingFromPersistence	Teradata	SELECT_UT_RATING
massiveSelectCurrencyForCreditLetter	Nsbt	ConsultaMonedasCartasDeCreditoCobranzas
massiveSelectCurrencyForImportExportCollection	Nsbt	ConsultaMonedasCartasDeCreditoCobranzas
massiveSelectCustomerByClient	NSBT-FU	BusquedaPersonasPorCliente
massiveSelectCustomerById	NSBT-FU	BusquedaPersonasPorDocumento
massiveSelectCustomerByName	NSBT-FU	BusquedaPersonasPorNombre
massiveSelectCustomerIdentificationDistinct	Profiling	massiveSelectCuit
massiveSelectCustomerMembers	Teradata	SELECT_UT_CUSTOMER_GROUP_INTEGRATION
massiveSelectCustomerName	Nsbt	ConsultaNominativoDeDocumento
massiveSelectCustomerOperationAndSecurityItem	Profiling	SignatureSchemaServiceMassiveSelectProductsAndSecurityItems
massiveSelectCustomerOperationByExample	Nsbt	PosicionConsolidada
massiveSelectCustomerOperationByExample	Nsbt	PosicionConsolidada
massiveSelectCustomerOperationByExampleFU	NSBT-FU	PosicionConsolidada
massiveSelectCustomerOperationByProcedure	Teradata	SELECT_UT_EXISTING_PRODUCT_MANAGEMENT
massiveSelectCustomerOperationPermissionAssignedBySystemUser	Profiling	massiveSelectProductByOperatorAssigned
massiveSelectCustomerOperationProfiled	Profiling	massiveSelectCustomerOperation
massiveSelectCustomerOperationProfiled	Profiling	massiveSelectCustomerOperation
massiveSelectCustomerOperationProfiled	Profiling	massiveSelectCustomerOperation
massiveSelectCustomerOperationProfiled	Profiling	massiveSelectCustomerOperation
massiveSelectCustomerOperationTEST	Nsbt	PosicionConsolidadaTest
massiveSelectCustomerOperationYearBalance	NSBT-PERSONAS	ConsultaPosicionConsolidadaUltimoAnio
massiveSelectCustomerPendingAdhesion	Nsbt	ConsultaClientesPendientesML
massiveSelectCustomerSystemUser	NSBT-FU	BusquedaOficialesPorPersona
massiveSelectDebinByFilters	InterBanking	listarDebin
massiveSelectDebtCardMovs	NSBT-FU	ConsumosTarjetaDebito
massiveSelectDependencyByWageAgreement	NSBT-PS	ConsultaDependenciasConvenio
massiveSelectEducationalInstitution	NSBT-FU	ConsultaUniversidades
massiveSelectEftAccessionByCustomer	NSBT-PERSONAS	ConsultaDebitosAdheridos
massiveSelectEftTransferPaymentOrder	NSBT-COMEX	transferenciasAlExterior
massiveSelectEmployerBySystemUser	Nsbt	ConsultaNominaConvenio
massiveSelectEmployerCompleteForPayment	NSBT-PS	ConsultaNominaBeneficiariosPagoCompleta
massiveSelectEmployerForDeletion	NSBT-PS	MassiveSelectEmployerForDeletion
massiveSelectEmployerForPayment	NSBT-PS	ConsultaNominaBeneficiariosPago
massiveSelectEmployerPaymentBook	NSBT-PS	ConsultaListasHabitualesPago
massiveSelectEmployerPaymentByBatchId	NSBT-PS	DetalleDeAcreditaciones
massiveSelectEmployerPaymentHist	NSBT-PS	ConsultaHistorialAcreditaciones
massiveSelectErrorCodeByCustomer	Teradata	SELECT_PROSPECT_DATA_VALIDATION
massiveSelectErrorFileDispatch	NSBT-PS	ConsultaDeErrores
massiveSelectEscrow	NSBT-CASH	ConsultaDeFideicomisosParaEnvioDeArchivo
massiveSelectEscrowByAccount	NSBT-CASH	ConsultaDeFideicomisos
massiveSelectEscrowInterface	NSBT-CASH	ConsultaDeArchivosFideicomisos
massiveSelectEticketConcept	NSBT-COMEX	ObtenerCombosConcepto
massiveSelectEticketRequest	NSBT-COMEX	boletoElectronicoTransfExt
massiveSelectEticketRequestTaxation	NSBT-COMEX	BoletoElectronicoVentas
massiveSelectExpensesFlow	NSBT-CASH	ConsultaFlujoDeEgresos
massiveSelectExportLicense	NSBT-COMEX	ConsultaPermisoDeEmbarqueAsignadosAlBanco
massiveSelectExportLicenseByRequestNumber	NSBT-COMEX	Doc_Aduaneros
massiveSelectExportLicenseEticket	NSBT-COMEX	BoletoElectronicoCompras
massiveSelectExportLicenseUse	NSBT-COMEX	AplicacionesRegimenesInformativo
massiveSelectFileDispatchConfirmation	NSBT-PS	ConsultaYConfirmacionDeEnvios
massiveSelectFileDispatchSystemUserName	Profiling	consultaPersonaServicioDoConsultNameLastName
massiveSelectFixedTermProductType	NSBT-PERSONAS	ConsultaParametrosTipoPlazoFijo
massiveSelectFixedTermRate	NSBT-PERSONAS	ConsultaCuadroTasasPlazoFijo
massiveSelectFundDestinyForLoan	NSBT-ML	ConsultaDestinoFondosPrestamoCalifGlobal
massiveSelectFundFinalAmount	Nsbt	FCIRetornaValoresAjustados
massiveSelectFundMov	Nsbt	FCIConsultaDetalleMovimientos
massiveSelectHolidayDay	NSBT-PS	ConsultaFeriados
massiveSelectImportExportCollectionAvailableToPay	NSBT-COMEX	SeleccionDeCobranzasVencidasPorVencerALiquidar
massiveSelectImportExportCollectionByOperation	NSBT-COMEX	SeleccionDeCobranzasPorOperaciones
massiveSelectImportExportCollectionOvercome	NSBT-COMEX	SeleccionDeCobranzasVencidasPorVencerALiquidar
massiveSelectImportExportCollectionOverdue	NSBT-COMEX	SeleccionDeCobranzasVencidasPorVencerALiquidar
massiveSelectImportExportCollectionUpdates	NSBT-COMEX	ConsultaDeModificacionesDeCobranzas
massiveSelectImportOperation	NSBT-COMEX	consultaDeOperacionesDeImportaciones
massiveSelectImportRegistry	NSBT-COMEX	ConsultaOficializacionesNominadas
massiveSelectInstitution	Profiling	WSInstitutionMassiveSelectInstitution
massiveSelectInsuranceCompanyForCreditCard	NSBT-FU	ConsultaCompaniasAseguradorasMaster
massiveSelectInsuranceCoverageByPlan	ISOL	CoberturaPorPlanISOL
massiveSelectInsurancePersistence	Teradata	SELECT_UT_INSURANCE_INTEGRATION
massiveSelectInsurancePlanByCompany	ISOL	ConsultaPlanesPorCompania
massiveSelectKitDeliveryDates	Nsbt	ConsultaFechasTramiteBPM
massiveSelectLegalTextEticket	NSBT-COMEX	Literales
massiveSelectLegalTextEticketByConcept	NSBT-COMEX	ConsultaDeTextosLegalesPorConceptos
massiveSelectLimitCardDb	Nsbt	ConsultaLimiteTarjetaDb
massiveSelectLoanFixedTermByAccountJudicial	Nsbt	PoderJudicialDetalleCuenta
massiveSelectLoanOfferedAmount	NSBT-PERSONAS	ConsultarMontosdePrestamo
massiveSelectLoanPreempted	NSBT-PERSONAS	ConsultaOpcionesPrestamosPreemitidos
massiveSelectLogMovByCardDb	NSBT-PERSONAS	ConsultaConsumosTarjetaDebito
massiveSelectLog_MovHist	Nsbt	consultaMovimientosCuenta
massiveSelectNonmonetaryTransaction	Profiling	massiveSelectSignatureSchema
massiveSelectNonmonetaryTransactionCheckRecovery	Profiling	massiveSelectSignatureSchema
massiveSelectOfferAcceptedByProcedure	Teradata	SELECT_UT_PROSPECT_ACCEPTED_PRODUCT
massiveSelectOfferComponentAccepted	Teradata	SELECT_UT_PROSPECT_ACCEPTED_OPTIONAL
massiveSelectOfferForFixedIncome	Teradata	SELECT_UT_OFFER_PRODUCT_DETAIL
massiveSelectPackageProductAccount	NSBT-FU	ConsultaDePaquetesMonoProductosDelCliente
massiveSelectPackageProductAll	Nsbt	ConsultaDePaquetes
massiveSelectPaymentOrderByAdherent	Nsbt	ConsultaDeOrdenesDePago
massiveSelectPaymentOrderByBeneficiary	NSBT-CASH	ConsultaOrdenesPago-Portales
massiveSelectPensionPayment	NSBT-PERSONAS	ConsultaJubilaciones
massiveSelectProcedureLogByProcedure	Teradata	SELECT_UT_BPM_TRACKING
massiveSelectProcedureTaskByProfileGroup	Profiling	massiveSelectActivityBTBPM
massiveSelectProcedureTaskByProfileGroupProcedure	Profiling	massiveSelectActivityBT
massiveSelectProcedureTaskByProfileProcedure	Profiling	massiveSelectActivityBPM
massiveSelectProcedureTaskProcedureByFilter	Profiling	massiveSelectActivityFilter
massiveSelectProcedureTaskTypeByProfile	Profiling	massiveSelectActivityBPMBPM
massiveSelectProcedureTypeProcedureByFilter	Profiling	massiveSelectActionFilter
massiveSelectProductByCampaignML	Teradata	RecuperaProductosPorCampania
massiveSelectProductByPackage	NSBT-FU	ConsultaDeProductosPorPaquete
massiveSelectProductDetailByOffer	NSBT-FU	ConsultaDetalleDeProductosPorOferta
massiveSelectProductPackageIdByCreditCard	Teradata	SELECT_UT_TC_OFFER_PACKAGE
massiveSelectProfessionBCRA	NSBT-FU	ConsultaCodigoBCRA
massiveSelectProfessionBCRATributaryCodes	Nsbt	ObtieneTiposAFIPBCRA
massiveSelectProfessionDescription	Nsbt	ConsultaCodigosActividad
massiveSelectProfessionTributary	NSBT-FU	ConsultaCodigosActividadAFIP
massiveSelectProfessionTributaryCodes	Nsbt	ObtieneCodigosAFIP
massiveSelectProfile	Profiling	wsProfileMassiveSelectProfile
massiveSelectProfileGroupProcedureByFilter	Profiling	massiveSelectProfileBTFilter
massiveSelectProfileProcedureByFilter	Profiling	massiveSelectRolBPMFilter
massiveSelectProfileProcedureByProcedure	Profiling	massiveSelectRolBPM
massiveSelectProspectInstitution	Profiling	massiveSelectPreadhesion
massiveSelectProvinceCodeByCountry	Nsbt	massiveSelectProvinceCodeByCountry
massiveSelectQuestionAnswerChallenge	Profiling	iwsPreguntaSecretaServiceMassiveSelectQuestionAnswerChallenge
massiveSelectQuestionAnswerSelected	Profiling	iwsPreguntaSecretaServiceMassiveSelectQuestionAnswer
massiveSelectQuotationByCurrencies	Nsbt	ConsultaCotizacionDivisas
massiveSelectReceiptByCreditLetter	Nsbt	ComprobantesCartasCredito
massiveSelectReceiptByEftTransfer	NSBT-COMEX	ConsultaDeComprobantesDeTransacciones
massiveSelectRegion	Nsbt	ConsultaRegiones
massiveSelectRoleType	Profiling	massiveSelectRoleType
massiveSelectSecurityItem	Profiling	massiveSelectSecurityItem
massiveSelectSecurityItemForSchema	Profiling	massiveSelectSecurityItemForSchema
massiveSelectSignatoryByTransactionId	Profiling	transferenciasServiceConsultaMailsIntervinientes
massiveSelectSignatureSchema	Profiling	wsSignatureSchemaMassiveSelectSignatureSchema
massiveSelectSignatureSchemaExpiration	Profiling	massiveSelectTimeOutSignatureSchema
massiveSelectStatusReasonProcedure	NSBT-FU	ConsultaCodigoBPM
massiveSelectStockBond	Nsbt	ConsultaBonosAcciones
massiveSelectSwiftMessageByCreditLetter	Nsbt	SeleccionDeMensajesSWIFT
massiveSelectSystemUserByProfileGroup	Nsbt	ObtenerCorreosRegistrados
massiveSelectSystemUserEbankSonic	ModuloUsuariosSonic	getCompanyOperators
massiveSelectSystemUserInstitution	Profiling	massiveSelectSystemUserInstitution
massiveSelectSystemUserInstitution	Profiling	massiveSelectSystemUserInstitution
massiveSelectSystemUserInstitutionAdministrator	Profiling	massiveSelectSystemUserInstitutionAdministrator
massiveSelectSystemUserInstitutionIdNumber	Profiling	massiveSelectSystemUserInstitutionCustom
massiveSelectTargetDataTransactionNightMode	Profiling-Personas	massiveSelectTargetDataTransactionNightMode
massiveSelectTaxationOptionFutureLicense	NSBT-COMEX	Concepto_102_103_106
massiveSelectTaxationOptionMulc	NSBT-COMEX	Opciones_DDJJ_MULC
massiveSelectTokenFile	Nsbt	GeneraTokenSubidaBajada
massiveSelectTransactionByType	Profiling	consultaTransaccionPorTipo
massiveSelectTransactionGroupPending	Profiling	consultaTransaccionesAgrupadas
massiveSelectTransactionSetDetail	Profiling	transferenciasServiceConsultaMonetariaPorGrupos
massiveSelectTransactionSetFund	Profiling	IWSHistorialFondo
massiveSelectTransactionSetFundPendingAmount	Profiling	doConsultaFondosExecuted
massiveSelectTransactionSetGeneral	Profiling	wsTransaccionesMonetariasDoConsultaTransaccionMonetariaPorFiltro
massiveSelectTransactionSetJudicialHist	Nsbt	doConsultaHistoricoPoderJudicial
massiveSelectUtilization	NSBT-COMEX	ConsultaUtilizacionesCartasDeCredito
massiveSelectWageAgreementByCustomer	NSBT-FU	ConsultaPlanSueldo
massiveSelectZoneByRegion	Nsbt	ConsultaZonaPorRegion
modifyAccountBook	Nsbt	ABMAgendaDeCBU
modifyAccountBookBeneficiary	NSBT-COMEX	AgendaDeTransferenciasComex
modifyAccountBukNumberAlias	Banelco	modificarAlias
modifyAccountDebinRequestStatus	Profiling	modifyAccountDebinRequestStatus
modifyAuthenticationToUser	Profiling	iwsCambioCredencialDoCambioCredencial
modifyAuthenticationToUser	Profiling	iwsCambioCredencialDoCambioCredencial
modifyAuthenticationToUserBanelco	Banelco	BNLCCambioPin
modifyAuthenticationToUserForgotPassword	Profiling	doOlvidoCredencial
modifyAuthenticationToUserReset	Profiling	iwsCambioCredencialDoCambioCredencial
modifyBpmProcessUIF	NSBT-FU	ActualizacionLegagosUIF
modifyChannel	Profiling	modifyChannel
modifyContactPhone	Profiling	modifyCellPhone
modifyCreditRatingSelection	Teradata	UPDATE_UT_RATING
modifyCustomerAdditionalDataProspect	Teradata	UPDATE_UT_CUSTOMER_ADDITIONAL_DATA
modifyCustomerBORRAR	Nsbt	ConsultaClientesPendientesML
modifyCustomerDuc	NSBT-PERSONAS	ModificacionDatosDUC
modifyCustomerIncomeMonotributoProspect	Teradata	UPDATE_UT_PROSPECT_ADDITIONAL_DATA
modifyCustomerIncomeProspect	Teradata	UPDATE_UT_PROSPECT_TARGET_ESTIMATED_INCOME
modifyCustomerOperation	Profiling	customerOperationCustomModifyCustomerOperation
modifyCustomerStatusPendingAdhesion	Nsbt	ActualizacionClientesPendML
modifyCustomerStatusProspect	Teradata	UPDATE_UT_PROSPECT_TARGET_STATUS
modifyDataExecutionTransactionStatusByDebinId	Profiling	doUpdateByDebin
modifyDebinBank	InterBanking	modificarDatosBanco
modifyEmployerPaymentBook	NSBT-PS	ModificacionListaHabitualesPago
modifyInstitution	Profiling	WSInstitutionModifyInstitution
modifyNonmonetaryTransactionByExecution	Profiling	updateByExecution
modifyNonmonetaryTransactionDebinStatus	Profiling	doUpdateByDebinNoMonetario
modifyProcedureIdCreditRating	Teradata	UPDATE_UT_RATING_INSTANCE
modifyProcedureIdOffer	Teradata	UPDATE_UT_ACCEPTED_INSTANCE
modifyProcedurePackagePersistence	Teradata	UPDATE_UT_BPM
modifyProfile	Profiling	wsProfileModifyProfile
modifyProspectInstitution	Profiling	modifyPreadhesion
modifyProspectInstitution	Profiling	modifyPreadhesion
modifyProspectInstitution	Profiling	modifyPreadhesion
modifyRoleType	Profiling	modifyRoleType
modifySecurityItem	Profiling	wsSecurityItemModifySecurityItem
modifySecurityItem	Profiling	wsSecurityItemModifySecurityItem
modifySignatureSchema	Profiling	modifySignatureSchema_esquema
modifySystemUserEmail	Profiling	iwsModificacionCorreoService
modifySystemUserInstitution	Profiling	modifySystemUserInstitution
modifySystemUserInstitution	Profiling	modifySystemUserInstitution
modifyTargetDataTransactionByExecution	Profiling	wsTransaccionesMonetariasServiceDoUpdateByExecution
modifyTargetDataTransactionByExecutionMassive	Profiling	modifyTargetDataTransactionByExecutionMassive
modifyTransactionSetFundUpdate	Profiling	doUpdateByImporte
processAccountDebinRequestAuthorize	Profiling	authorizeRequestAccountDebin
processAccountDebinRequestRevoke	Profiling	revokeRequestAccountDebin
processBatchFileDependencyUpload	NSBT-PS	AltaDependeciaArchivo
processBatchFileEmployerPayment	NSBT-PS	PagoDeHaberesArchivo
processBatchFileEmployerUpload	NSBT-PS	AltaDeEmpleadoPorArchivo
processBatchFileEscrow	NSBT-CASH	EnviarArchivoDeFideicomisos
processBatchFileEscrowChecksum	NSBT-CASH	EnviarChecksumDeFideicomisos
processChannelAuthorize	Profiling	processChannelAuthorize
processChannelDisable	Profiling	processChannelDisable
processChannelEnable	Profiling	processChannelEnable
processChannelRevoke	Profiling	processChannelRevoke
processCheckDetailCashAddRemove	NSBT-CASH	SeleccionarDesSeleccionarChequesRecupero
processCheckDetailRecoveryBatch	NSBT-CASH	GenerarLoteParaRecuperoDeCheques
processCodeCardActivate	Profiling	WScoordinateCardProcessCoordinateCardActivate
processCodeCardRead	Profiling	processCoordinateCardRead
processCodeCardRegenerate	Profiling	WSSystemUserInstitutionProcessRegenerateCoordinateCard
processContactPhoneAuthorize	Profiling	processCellPhoneAuthorize
processContactPhoneEnable	Profiling	WSTelefonoCelularServiceProcessCellPhoneEnable
processContactPhoneRevoke	Profiling	processCellPhoneRevoke
processCreditCardNameOnCard	Nsbt	EmbozadoTarjeta
processCreditRatingFreeLimit	Nsbt	processCreditRatingReserveLimit
processCreditRatingOverallFromBantotal	NSBT-FU	CalificacionGlobalBantotal
processCreditRatingReserveLimit	Nsbt	processCreditRatingReserveLimit
processCustomerOperationMerge	Profiling	iwsMergeProductosProcessCustomerOperationMerge
processCustomerOperationPackageComposition	NSBT-FU	AltaRepaquetizacionPaquete
processDebinBankMode	InterBanking	setearModoBanco
processDebinCreditStatusMerge	Profiling	doUpdateByDebinListNoMonetario
processDebinStatusMerge	Profiling	doUpdateByDebinList
processEmailAccountBook	MailSender	agendaCuentas
processEmailAuthenticationSuspectBasic	MailSender	FactorAutorizacionSospechoso
processEmailBatchFileEscrow	MailSender	FideicomisoAutorizacion
processEmailCbu	MailSender	ConsultaCBU
processEmailCbuSuspect	MailSender	AgendaCbuListaNegra
processEmailCodeCardExceptionMode	MailSender	TokenSmsModoExcepcion
processEmailCollectionReceipt	MailSender	ComprobantesDeCobranzas
processEmailCredentialsReset	MailSender	BlanqueoCredenciales
processEmailCreditLetterReceipt	MailSender	ComprobantesDeCartasdeCredito
processEmailDebinAuthorize	MailSender	AutorizacionDebin
processEmailDebinBukNumberSuspect	MailSender	MensajesCBUSospechoso
processEmailDebinBukNumberSuspect	MailSender	MensajesCBUSospechoso
processEmailDebinCreate	MailSender	CreacionDebin
processEmailDebinDelete	MailSender	EliminacionDebin
processEmailDebinDeleteAccountSource	MailSender	DesvinculacionCuentaDebinVendedor
processEmailDebinPayment	MailSender	CobroDebin
processEmailDebinProspectAccountSource	MailSender	adhesionCuentaDebinVendedor
processEmailDebinReception	MailSender	RecepcionDebin
processEmailDebinRejection	MailSender	RechazoDebin
processEmailFundSubscription	MailSender	SuscripcionFondoComunInversion
processEmailInstitutionAuthorize	MailSender	estructuraCredenciales
processEmailInstitutionAuthorizeTest	MailSender	EstructuraCredencialesTest
processEmailJudicialFileNumberChanged	MailSender	ModificacionExpedienteJudicial
processEmailMessage	MailSender	MensajesAlBanco
processEmailModifyProspectInstitution	MailSender	AltaEmpresaAdhesionOnline
processEmailPasswordChanged	MailSender	OlvidoClave
processEmailProcedurePackageContract	MailSender	AvisoCliente
processEmailProcedurePackageProductNotify	MailSender	AvisoAltaProductos
processEmailProcedurePackageProductNotify	MailSender	AvisoAltaProductos
processEmailProcedureTask	MailSender	AsignarTarea
processEmailProspectInstitution	MailSender	PreAdhesionEmpresa
processEmailProspectInstitutionForm	MailSender	PreAdhesionEmpresaPdf
processEmailQuestionAnswerUpdate	MailSender	modificacionPreguntasSecretas
processEmailRevokeAccreditationWage	MailSender	RechazoPagoSueldos
processEmailRevokeCashPaymentFile	MailSender	PagosCashRechazo
processEmailRevokeCheckbookRequest	MailSender	RechazoSolicitudChequeras
processEmailRevokeCheckRecovery	MailSender	RecuperoCPD
processEmailRevokeCollectionCash	MailSender	CobrosCashRechazo
processEmailRevokeDeleteEmployers	MailSender	RechazoAltaEmpleado
processEmailRevokeEticketRequestBuy	MailSender	BoletoElectronicoCompraRechazo
processEmailRevokeEticketRequestSell	MailSender	BoletoElectronicoVentaRechazo
processEmailRevokeFundRescue	MailSender	FondosLombardRescateRechazo
processEmailRevokeFundSubscription	MailSender	FondosLombardSuscripcionRechazo
processEmailRevokeInsertDependency	MailSender	RechazoAltaDependencia
processEmailRevokeInsertEmployers	MailSender	RechazoAltaEmpleado
processEmailRevokeSecurityTransferJudicial	MailSender	TransferenciaMepPoderJudicialRechazo
processEmailRevokeTransfer	MailSender	RechazoTransaccion2
processEmailRevokeTransfer	MailSender	RechazoTransaccion
processEmailSignAccreditationWage	MailSender	AutorizacionHaberes
processEmailSignatureSchemaExpiration	MailSender	VencimientoEsquemaFirmas
processEmailSignCashPaymentFile	MailSender	PagosCashAutorizacion
processEmailSignCheckbookRequest	MailSender	SolicitudChequeras
processEmailSignCheckRecovery	MailSender	RecuperoCPD
processEmailSignCollectionCash	MailSender	CobrosCash
processEmailSignDeleteEmployers	MailSender	ABMEmpleados
processEmailSignEticketRequestBuy	MailSender	BoletoElectronicoCompraAutorizacion
processEmailSignEticketRequestSell	MailSender	BoletoElectronicoVentaAutorizacion
processEmailSignFundRescue	MailSender	FondosLombardRescateAutorizacion
processEmailSignFundSubscription	MailSender	FondoLombardSuscripcionAutorizacion
processEmailSignInsertDependency	MailSender	AltaDependencia
processEmailSignInsertEmployers	MailSender	ABMEmpleados
processEmailSignSecurityTransferJudicial	MailSender	TransferenciaMepPoderJudicialSeguridad
processEmailSignTransferJudicial	MailSender	TransferenciaMepPoderJudicialAutorizacion
processEmailSwiftMessageCollection	MailSender	MensajesSWIFTdeCobranzas
processEmailSwiftMessageCreditLetter	MailSender	MensajesSWIFTdeCartasDeCredito
processEmailSystemUserAuthorizeML	MailSender	EstructuraMailingML
processEmailSystemUserBlocked	MailSender	OlvidoClave
processEmailSystemUserData	MailSender	modificacionDatosPersonales
processEmailSystemUserInhibitionRemove	MailSender	RecuperarTodo
processEmailSystemUserInstitutionAuthorize	MailSender	AltaOperador
processEmailSystemUserKeyReset	MailSender	RecuperoCodigo
processEmailSystemUserKeyword	MailSender	OlvidoUsuarioClave
processEmailTest	MailSender	EstructuraCredencialesTest
processEmailTransaction	MailSender	Transacciones
processEmailTransferMep	MailSender	TransferenciasMEP
processEmailTransferOwnAccount	MailSender	TransferenciaPropiaMismoBanco
processEmailTransferThirdPartiesOtherInstitution	MailSender	TransferenciasTercerosOtrosBancos
processEmailUsername	MailSender	OlvidoUsuario
processEmailUsernameChange	MailSender	ModificacionNombreUsuario
processEmployerPayment	NSBT-PS	PagoDeHaberesPlantilla
processEncryptionKeySms	Nsbt	GeneroMD5CheckEnvioSms
processEticketFileUpload	NSBT-COMEX	GrabarArchivoEnCarpeta
processEticketRequest	NSBT-COMEX	NavegaPantalla
processEticketRequestConfirmation	NSBT-COMEX	ConfirmarRechazar
processEticketRequestFutureLicense	NSBT-COMEX	NavegaPantalla
processEticketRequestLicense	NSBT-COMEX	NavegaPantalla
processEticketRequestMulc	NSBT-COMEX	NavegaPantalla
processEticketRequestSingularSign	NSBT-COMEX	ConfirmarRechazar
processEticketRequestTax	NSBT-COMEX	NavegaPantalla
processExportLicenseEticketAddRemove	NSBT-COMEX	BoletoElectronicoCompras
processFileDispatchConfirmation	NSBT-PS	ConfirmarEnvio
processFileDispatchMepUpdate	NSBT-CASH	ActualizarSSTRANS
processInstitutionAuthorize	Profiling	processInstitutionAuthorize
processInstitutionFirstLogin	Profiling	verifyInstitutionLogin
processInstitutionMigration	Profiling	doMigrarEmpresa
processNonmonetaryTransactionSingularRevoke	Profiling	processSignatureSchema_nonmonetary
processNonmonetaryTransactionSingularSign	Profiling	processSignatureSchemaSign
processNonmonetaryTransactionSingularSign	Profiling	insertSignatureSchema
processProspectAdministratorKeyReset	Profiling	resetPalabraClave
processProspectInstitutionAuthorize	Profiling	processAuthorizePreadhesion
processProspectInstitutionRevoke	Profiling	processPreadhesionRevoke
processProspectMark	Profiling	processProspectMark
processProspectMarkBORRAR	Profiling	processProspectMark-BORRAR
processProspectMarkBORRAR	Profiling	processProspectMark-BORRAR
processQuestionAnswerUpdate	Profiling	iwsPreguntaSecretaServiceCustom
processRoleTypeAuthorize	Profiling	processRoleTypeAuthorize
processRoleTypeRevoke	Profiling	processRoleTypeRevoke
processSignatureSchemaAuthorize	Profiling	wsSignatureSchemaProcessSignatureSchemaAuthorize
processSignatureSchemaDisable	Profiling	processSignatureSchemaDisable
processSignatureSchemaEnable	Profiling	processSignatureSchemaEnable
processSignatureSchemaRevoke	Profiling	processSignatureSchemaRevoke
processSingularTransactionBatchFileCash	NSBT-CASH	ProcesarRechazarArchivo
processSingularTransactionCheckbookRequest	Nsbt	SolicitudDeChequera
processSingularTransactionCheckbookRequest	Nsbt	SolicitudDeChequera
processSingularTransactionCheckRecovery	NSBT-CASH	ProcesarRechazarRecupero
processSingularTransactionConfirmDebit	InterBanking	confirmarDebin
processSingularTransactionCredit	Nsbt	AplicarCreditoDebin
processSingularTransactionDebin	Nsbt	AplicarDebitoDebin
processSingularTransactionDebinCredit	InterBanking	crearDebin
processSingularTransactionDebinDeletion	InterBanking	eliminarDebin
processSingularTransactionDebit	Nsbt	AplicarDebitoDebin
processSingularTransactionEticketRequest	NSBT-COMEX	ConfirmarRechazar
processSingularTransactionFileDispatch	NSBT-PS	EjecutarEnvio
processSingularTransactionFileDispatchRevoke	NSBT-PS	EjecutarEnvio
processSingularTransactionFixedTerm	NSBT-PERSONAS	ConfirmacionPlazoFijo
processSingularTransactionFixedTermSimulation	NSBT-PERSONAS	ConsultaDatosConfirmarPlazoFijo
processSingularTransactionFundRescue	Nsbt	RescateFondos
processSingularTransactionFundSubscription	Nsbt	SuscripcionFCI
processSingularTransactionLoanRequest	NSBT-PERSONAS	ConfirmacionPrestamoPermitido
processSingularTransactionLoanSimulation	NSBT-PERSONAS	AltaPrestamoPreemitido
processSingularTransactionReverse	Nsbt	ReversaDebin
processSingularTransactionTransferOtherInstitutionAccountNumber	Banelco	TransferirConCuentaBanelco
processSingularTransactionTransferOtherInstitutionBukNumber	NSBT-PERSONAS	TransferenciaConCBU
processSingularTransactionTransferOwnAccount	Nsbt	TransferenciaCuentasPropias
processSingularTransactionTransferOwnAccountSimulation	NSBT-PERSONAS	ValidarCuentaTransferenciaNSBT
processSingularTransactionTransferPersonOwnAccount	NSBT-PERSONAS	ConfirmarTransferencia
processSingularTransactionTransferPersonThirdPartiesSameInstitution	NSBT-PERSONAS	ConfirmarTransferenciasTercerosPatagonia
processSingularTransactionTransferThirdPartiesJudicial	Nsbt	TransfCuentasPatagoniaPorCBU
processSingularTransactionTransferThirdPartiesJudicialMep	Nsbt	TransferenciasJudicialMEP
processSingularTransactionTransferThirdPartiesOtherInstitution	Nsbt	TransferenciaCuentaTercerosOtroBanco
processSingularTransactionTransferThirdPartiesOtherInstitutionMep	Nsbt	TransferenciaMEP
processSingularTransactionTransferThirdPartiesSameInstitution	Nsbt	TransferenciaCuentasTercerosMismoBanco
processSms	MovilGate	EnvioMT
processSystemUserBlocked	Profiling	processSystemUserBlock
processSystemUserDiligence	NSBT-PERSONAS	processSystemUserDiligence
processSystemUserFirstLogin	Profiling	iwsLoginDoPrimerLogin
processSystemUserInhibitionRemove	Profiling	doRemoveInhibition
processSystemUserInstitutionAuthorize	Profiling	processSystemUserInstitutionAuthorize
processSystemUserInstitutionDisable	Profiling	processSystemUserInstitutionDisable
processSystemUserInstitutionEnable	Profiling	processSystemUserInstitutionEnable
processSystemUserInstitutionRevoke	Profiling	processSystemUserInstitutionRevoke
processSystemUserKeyReset	Profiling	iwsCambioCredencialDoResetPalabraClave
processSystemUserKeyword	Profiling	WSCambioCredencialServiceDoBlanqueo
processTransactionSetConfectionBasic	Profiling	transferenciasServiceConfeccion
processTransactionSetSignatureBasic	Profiling	doSignTransaccionMonetaria
processTransactionSetSingularRevoke	Profiling	processTransactionSetRevoke
processTransactionSetSingularRevoke	Profiling	processTransactionSetRevoke
singleSelectAccountBukAliasFromBukNumber	Banelco	obtenerAliasDesdeCBU
singleSelectAccountBukNumber	NSBT-PERSONAS	ConsultaCBU
singleSelectAccountBukNumberFromAlias	Banelco	obtenerCBUDesdeAlias
singleSelectAccountClubPatagonia	NSBT-FU	ConsultaCuentaClubPatagonia
singleSelectAccountDebinOrigin	InterBanking	consultarVendedor
singleSelectAccountDebinRequest	Profiling	singleSelectAccountDebinRequest
singleSelectAccountDebinTarget	InterBanking	consultarComprador
singleSelectAccountHolder	NSBT-PERSONAS	ConsultaNominativoDeCuenta
singleSelectAccountJudicialBalance	Nsbt	PJ-DescargaDeSaldos
singleSelectAccountNumberFromBukNumber	Nsbt	ConsultaCuentaporCBU
singleSelectAccountNumberFromBukNumber	Nsbt	ConsultaCuentaporCBU
singleSelectAvailableTransactionProcedure	Profiling	singleSelectActivityFilter
singleSelectBasicIndividualData	Nsbt	ConsultaDocumentoBantotal
singleSelectBasicIndividualDataOld	Nsbt	ConsultaDocumentoBantotalOld
singleSelectBatchFileAccountReturn	NSBT-PS	DevolucionDeCuentas
singleSelectBatchFileTote	NSBT-PS	ConsultaCorteArchivo
singleSelectCashReferencesByAgreement	Nsbt	ConsultaReferenciasConvenio
singleSelectChannel	Profiling	singleSelectChannel
singleSelectCheckDetailRecovered	NSBT-CASH	DetalleRecuperoCPD
singleSelectCodeCard	Profiling	wsSingleSelectCoordinateCard
singleSelectContactPhone	Profiling	singleSelectCellPhone
singleSelectContactPhoneByCustomer	Profiling	singleSelectCellPhoneByCustomer
singleSelectContactPhoneBySystemUser	Profiling	ConsultaContactPhonePorUsuario
singleSelectCreditCardBORRAR	Test	ConsultaDePersonasPRUEBAS
singleSelectCreditLetterImportExport	Nsbt	DatosBasicosCartaDeCredito
singleSelectCreditLetterUpdates	NSBT-COMEX	DetalleDeModificacionesDeCartaDeCredito
singleSelectCustomerAdditionalDataFromProspect	Teradata	SELECT_UT_CUSTOMER_ADDITIONAL_DATA
singleSelectCustomerBantotal	NSBT-FU	ConsultaDeClientes
singleSelectCustomerByAlias	Profiling	iwsCustomerServiceSingleSelectCustomerByAlias
singleSelectCustomerByAlias	Profiling	iwsCustomerServiceSingleSelectCustomerByAlias
singleSelectCustomerContactData	NSBT-FU	DatosUnicosCliente
singleSelectCustomerDuc	NSBT-PERSONAS	ConsultaDatosDUC
singleSelectCustomerFromProspect	Teradata	SELECT_UT_CUSTOMER_GROUP
singleSelectCustomerIdentificationAlternative	NSBT-FU	ConsultaDocumentoAlternativo
singleSelectCustomerPersonAdditionalDataFromProspect	Teradata	SELECT_PROSPECT_ADDITIONAL_DATA
singleSelectCustomerPersonBantotal	NSBT-FU	ConsultaPersonaBantotal
singleSelectCustomerPersonCreditRating	Teradata	SELECT_UT_PROSPECT_TARGET
singleSelectCustomerStatusTeradata	Teradata	CUSTOMER_PORTFOLIO_STATUS
singleSelectDateRangeForDebin	Profiling	doConsultaFechasDebin
singleSelectDateRangeForDebinCredit	Profiling	doConsultaFechasDebinNoMonetario
singleSelectDebin	InterBanking	consultarDebin
singleSelectDebinDateTime	InterBanking	consultarFechaHora
singleSelectDependencyErrorByRowId	NSBT-PS	ObtenerContenidoEnvioDependencias
singleSelectDynamicAuthenticationByAlias	Profiling	wsDoPreLogin
singleSelectEftTransferPaymentOrder	NSBT-COMEX	transaccionesDatosBasicos
singleSelectEmployerErrorByRowId	NSBT-PS	ObtenerContenidoEnvioEmpleados
singleSelectEmployerPaymentBook	NSBT-PS	ConsultaListaPagoHabitualDetalle
singleSelectEmployerPaymentErrorByRowId	NSBT-PS	ObtenerContenidoEnvioPAgoHaberes
singleSelectEscrowFileStatus	NSBT-CASH	ConsultaEstadoEnvioArchivoFideicomiso
singleSelectEscrowParameter	Nsbt	ConsultaDicFideicomiso
singleSelectEticketRequest	NSBT-COMEX	ObtenerBoleto
singleSelectEticketRequestConcept	NSBT-COMEX	ObtenerBoleto
singleSelectEticketRequestDownload	NSBT-COMEX	DescargaDeBoletoElectronico
singleSelectEticketRequestFile	NSBT-COMEX	ObtenerBoleto
singleSelectEticketRequestFutureLicense	NSBT-COMEX	ObtenerBoleto
singleSelectEticketRequestMulc	NSBT-COMEX	ObtenerBoleto
singleSelectEticketRequestTax	NSBT-COMEX	ObtenerBoleto
singleSelectEticketRequestToken	NSBT-COMEX	DescargaDeBoletoElectronico
singleSelectExportLicense	NSBT-COMEX	DatosBasicosRI
singleSelectExportLicenseUse	NSBT-COMEX	PermisosDeEmbarqueDetalleAplicaciones
singleSelectFundSettlementFile	Esco	ComprobanteFondoComunInversion
singleSelectHeritageProfile	NSBT-FU	DatosPerfilPatrimonial
singleSelectImportExportCollection	NSBT-COMEX	DetalleDeCobranzas
singleSelectImportExportCollectionUpdates	NSBT-COMEX	DetalleDeModificacionesDeCobranzas
singleSelectInstitution	Profiling	WSInstitutionSingleSelectInstitution
singleSelectInsuranceInfo	NSBT-FU	ConsultaDatosSeguro
singleSelectLoanDuesSchedule	NSBT-FU	ConsultaCronogramaCuotas
singleSelectLoggedSessionOficial	NSBT-FU	DatosOficialLogueado
singleSelectNonmonetaryTransaction	Profiling	singleSelectSignatureSchema
singleSelectOfferOrder	Teradata	SELECT_UT_OFFER_PACKAGE_ORDER
singleSelectParametersEmployeeAndCustomer	NSBT-FU	ConsultaEmpleadoTipoCliente
singleSelectPaymentOrder	Nsbt	PS-ConsultaOrdenPago
singleSelectPaymentOrderByBeneficiary	NSBT-CASH	DetalleOrdenPago-Portales
singleSelectProcedureByCustomer	Teradata	SELECT_UT_BPM_CUSTOMER
singleSelectProcedureDraftPersistence	Teradata	SELECT_UT_PRE_BPM
singleSelectProcedurePackagePersistence	Teradata	SELECT_UT_BPM_INSTANCE
singleSelectProcedureTaskProcedure	Profiling	singleSelectActivityFilter
singleSelectProcedureTypeProcedure	Profiling	singleSelectProcessFilter
singleSelectProductDetail	NSBT-FU	ConsultaTipoDeProducto
singleSelectProfessionBCRATributaryCodes	Nsbt	ObtieneCodsBCRA-AFIP
singleSelectProfile	Profiling	wsProfileSingleSelectProfile
singleSelectProfileGroupProcedure	Profiling	singleSelectProfileBTFilter
singleSelectProfileProcedure	Profiling	singleSelectRolBPMfilter
singleSelectProspectInstitution	Profiling	singleSelectPreadhesion
singleSelectProspectInstitutionByProspectNumber	Profiling	selectRequestByRequestNumber
singleSelectReceiptFileByCreditLetter	NSBT-COMEX	DescargaComprobantes
singleSelectReceiptFileByTransfer	NSBT-COMEX	DescargaComprobantes
singleSelectReceiptPaymentOrder	Nsbt	ObtenerComprobante
singleSelectRoleType	Profiling	singleSelectRoleType
singleSelectScannedDocumentForCheck	Provincanje	ImagenCheque
singleSelectSecurityItem	Profiling	wsSecurityItemSingleSelectSecurityItem
singleSelectSignatureSchema	Profiling	singleSelectSignatureSchema_esquema
singleSelectSwiftMessageFile	NSBT-COMEX	DescargaDeMensajesSWIFT
singleSelectSystemUserCredentials	Nsbt	ConsultaCredencialesSistema
singleSelectSystem_UserFunctionalities	Profiling	iwsObtenerFuncionalidadesOperadorCanal
singleSelectSystemUserInstitution	Profiling	WSSystemUserInstitutionSingleSelectSystemUserInstitution
singleSelectSystemUserInstitutionBORRAR	Profiling	WSSystemUserInstitutionSingleSelectSystemUserInstitution
singleSelectTicketMessage	Nsbt	EnvioMensajeAlBanco
singleSelectToken	Nsbt	GeneraToken
singleSelectTransactionSetBathFileCashStatus	NSBT-CASH	ConsultaArchivo
singleSelectTransactionSetByDebinId	Profiling	doConsultaDebin
singleSelectUtilization	NSBT-COMEX	DetalleDeUtilizacionesCartasDeCredito
verifyAccountBookAlias	Nsbt	ValidaAlias-CBUenAgenda
verifyAccountFundSubscription	Nsbt	ValidacionPrimerSuscripcionFCI
verifyAccountIsNaturalPerson	Nsbt	BuscaTipoTitularClienteBT
verifyAccountThirdPartiesOtherInstitution	Banelco	consultarDatosTitularidad
verifyAccountThirdPartiesOtherInstitutionExtended	Banelco	consultarDatosTitularidadExtendida
verifyAccountThirdPartiesSameInstitution	Nsbt	ValidacionCBU
verifyAuthenticationCreditCardNumber	Nsbt	ValidaDigitosTarjeta
verifyAuthenticationForLoginBanelco	Banelco	userLogin
verifyBankCbuAndCuit	InterBanking	verifyBancoCbuAndCuit
verifyBukNumberTypeAliasInterbanking	InterBanking	consultaAlias
verifyBukNumberTypeInterbanking	InterBanking	consultaCBU
verifyContactPhoneNotCallRegistry	Teradata	NO_CONTACT_PHONE
verifyCoordinateValue	Profiling	wsProcessCoordinateCardValidate
verifyCreditCardLimit	Teradata	CC_MIN_LIMIT_VALIDATION
verifyCreditCardLimitMax	NSBT-FU	CalculaLimiteMaximoTC
verifyCustomerIdentificationData	Teradata	ValidoDocumentoCliente
verifyCustomerIsPEP	Teradata	BUSQUEDA_PEP
verifyCustomerIsTerrorist	Teradata	BUSQUEDA_PEP
verifyCustomerPersonProspect	Teradata	INSERT_PROSPECT_DATA_VALIDATION
verifyCustomerProspectPensionDebt	Nsbt	ConsultaDeudaPrevisional
verifyDateIsEnabledByWageAgreement	NSBT-PS	ControlCadenaPagoHaberes
verifyDateIsEnabledPS	NSBT-PS	ControlCadena
verifyDateIsWorkingDay	Nsbt	ValidarFechaDiaHAbil
verifyDependency	NSBT-PS	ValidacionDependencia
verifyEmployer	NSBT-PS	VerifyEmployer
verifyEmployerByTest	NSBT-PS	VerifyEmployer
verifyEmployerPayment	NSBT-PS	ValidarPagoHaberes
verifyPermissionByEmployee	NSBT-FU	ConsultaPermisosDeEmpleado
verifyProdDocumentationRules	Nsbt	ConsultaMatrizDocumentacion
verifyProspectAdministratorKey	Profiling	WSPreadhesionClienteServiceValidacionClave
verifyQuestionAnswer	Profiling	iwsPreguntaSecretaServiceVerifyQuestionAnswer
verifyRoleTypeBySystemUserInstitution	Profiling	verificarInvestidurasOperadorEmpresa
verifySignatureSchema	Profiling	verifySignatureSchema
verifySignatureSchema	Profiling	verifySignatureSchema
verifySystemUserPasswordReset	Profiling	validateCustomerForUserPasswordReset
verifySystem_UserProfiling	Profiling	iwsLoginDoLogin
verifySystem_UserProfiling	Profiling	iwsLoginDoLogin
verifySystem_UserSecurity	Profiling	verificarSeguridadOperador
verifyTokenValue	Nsbt	ValidaToken
verifyTransactionSetBathFileCash	NSBT-CASH	EnviarArchivo
verifyTransactionSetLimits	Profiling	doValidateSignTransaccionMonetaria
